个中	個中
乾坤	乾坤
仿佛	彷彿
信息	信息
克星	剋星
准备	準備
准确	準確
准许	准許
历史	歷史
反复	反覆
台湾	台灣
向往	嚮往
启	啟
品尝	品嚐
回复	回覆
复兴	復興
复制	複製
复杂	複雜
复苏	復蘇
大相径庭	大相逕庭
天台宗	天台宗
天台山	天台山
奖杯	獎杯
峰	峯
干戈	干戈
干支	干支
干活	幹活
干涉	干涉
干燥	乾燥
念书	唸書
念佛	念佛
念经	念經
总结发言	總結發言
恒	恆
日历	日曆
杠杆	槓桿
栏杆	欄杆
树干	樹幹
污蔑	污衊
瑜伽	瑜伽
秋千	鞦韆
答复	答覆
经历	經歷
老板	老闆
舍利子	舍利子
艳		豔
茶几	茶几
饼干	餅乾
着	着
周会	週會
一周	一週
里	裏